#######
#. . .#
# BBB #
#.B&B.#
# BBB #
#. . .#
#######