   #####
####   #
#..#B# #
#    B #
#.B  #&#
#..BB# #
####   #
   #####