 #######
##&##..#
# BB B.#
#   B  #
####  .#
   #####