  ####
  #& #
### B#
# BB.##
# B.. #
# B.. #
#   ###
#####