 ####
 #  #
##  ###
# B.  #
# .B  #
#& .B #
###  ##
  ####