#######
#  &  #
# BBB #
##...##
# . . #
# B B #
#  #  #
#######