########
#..    #
#..B B #
#B#BBB##
#..B B&#
#..    #
########