  #####
###   #
#.&B  #
### B.#
#.##B #
# # . ##
#B XBB.#
#   .  #
########